1111111111111111111111111111111111
1E000000C000000C000000000C00000001
1010010100100000101001000000010101
1010010010101010001001000000010101
1P000000C00000000000000C0000000001
1111111111111111111111111111111111