1111111111111111111111111111111111
10000000C000001C000000000000000001
1000011100100000101001000000010101
101001E100101010001001000000010101
1P00000011000000000001010000000011
1111111111111111111111111111111111
