1111111111111111111111111111111111
1P000000E00000000C0000000000C00001
1111111111111111111111111111111111