11111111111111111111111111111111
1P0000000000000C00000C000000C001
11111111011111101110011100000101
10100100101010100010010000000101
110000000C10C0000011110000000001
100000000010000C00100C0011111001
10100101001000001010010011100101
10100100101110100010010001000101
10000000C00C00000000000001000001
100001010000000C00000C0001000001
10100101001000001010010011100101
10100101101010100010010000000101
100000000C00C000001000010E010001
11111111111111111111111111111111
